........##.....*......
........####..........
.........##...........
.........#...F.#......
.........#.#...##...F#
########...##.......##
######################
######################
----------------------

5,4,4,4,3,4