......xx#.
......###.
.......#..
..#....#.*
#.........
..FxF#..#.
.x......#.
.##.#...#.
.##.#...#.
.##.#...#.
.##.#...#.
----------

5,3,4,3
4,4,5,4