......*...
..........
...#......
..........
#.........
#.........
#..#......
...#......
......####
..........
..........
..........
----------

6,7,7,7,8,7
7,6,8,6,9,6,9,7