....*....
....x....
..F.N.F..
.........
.........
...21....
xxx3N..xx
NNN4F.xxN
NN.56..NN
NN.....NN
xxxxxxxxx