....*....
....x....
..F.N.F..
.........
.........
.........
xxx.N..xx
NNN.F.xxN
NN.....NN
NN.....NN
---------

4,5,3,5,3,6,3,7,3,8,4,8